111111111111111
100022222220001
101212121212101
102222222222201
121210121012121
122222020222221
121212121212121
122222020222221
121210121012121
102222222222201
101212121212101
100022222220001
111111111111111
